[dim] 6 6
[emp] 0 0 
[emp] 1 0 
[emp] 2 0 
[emp] 3 0 
[emp] 4 0 
[emp] 5 0 
[emp] 0 1 
[emp] 1 1 
[emp] 2 1 
[emp] 3 1 
[emp] 4 1 
[emp] 5 1 
[emp] 0 2 
[emp] 1 2 
[full] 2 2 d
[emp] 3 2 
[emp] 4 2 
[emp] 5 2 
[emp] 0 3 
[emp] 1 3 
[full] 2 3 r
[full] 3 3 e
[full] 4 3 a
[full] 5 3 l
[emp] 0 4 
[emp] 1 4 
[full] 2 4 o
[emp] 3 4 
[emp] 4 4 
[emp] 5 4 
[emp] 0 5 
[emp] 1 5 
[full] 2 5 w
[emp] 3 5 
[emp] 4 5 
[emp] 5 5 
[word] word
[word] real
